111111111111111111111111111111111111111111111111111111111111111
100000000000000000000000000000000011111111111110000000000000001
100000000000000000000000000000000011111111111110000000000000001
100000000000000000000004000000000011111111111110000000000000001
100000000000000000000000000000000011111111111110000000000011111
111111111111100000000000000000000000000000000000000000000011111
111111111111100000000000000000000000000000000000000000000011111
111111111111100000000000000000000000000000000000000001111111111
111111111111111111111111111111111111111111000000000001111111111
111111111111111111111111111111111111111111000000000001111111111
100000000000000000000000000000001110000000000000000000000000001
100000000000000000000000000000001110000000000000000000000000001
100000000000000000000000000000001110000000000000000000000000001
111100000000000111111111111110001111111111111111111111110000001
111100000000000111111111000000000000011111111111111111110000001
111100000000000111111111000000000000011000000000000000000000001
100000000000000000000011000000300000011000000000000000000000001
100000000000000000000011000000000000011000000000000000000000001
100000000000000000000011000000000000011000000001111111000000001
111111110000000000000011111111111111111000000001111111000000001
111111110000011111111111111111111111111000000001111111000000001
100000000000011100000000000000111000000000000000000000000000001
100000000000011100000000000000111000000000000000000000000000001
100000000000011100000000000000111000000000000000000000000000001
100000000000011100000011000000111000000111111111111111111111111
100000000000011100000011000000111000000111111111111111111111111
100000000000011100000011000000111000000000000000000000000000001
100000000000011100000011000000111000000000000000000000000000001
100000000000011100000011000000111000000000000000000000000000001
111111110000000000000011000000111111111111111111111111111100001
111111110000000000000011000000111111111111111111111111111100001
100000000000000000000011000000111111111111111111111111111100001
100000000000000000111111000000000000000000000000000000000000001
100000000000000000111111000000000000000000000000000000000000001
100000000000000000111111000000000000000000000000000000000000001
111111111111111111111111111111111111111111111111111111111111111