111111111111111111111111111111111111111111111111111111111111111
100000000000000000000001111000000000000000000000001000000000001
100000000000000000000001111000000000000000000000001000000030001
100000000000000000000001111000000000000000000000001000000000001
100000000000000000000001111000000000000000000000001000000000001
111111100011111111100001111000000000001111000000001111100011111
111111100011111111100001111111000000001111000000001111100011111
111111100011111111100001111111000000001111000000001111100011111
111111100011111111100000000111000000001111000000001111100000001
111111100011111111100000000111000000001111000000001111100000001
100000000011111111100000000111000000001111000000001111100000001
100000000011111111100001111111000000001111000000000000000000001
100000000011111111100001111111000000001111000000000000000000001
111000001111111111100001111111000000001111000000000000000000001
111000001111111111100001111111000000001111111111111111111111111
111000000000000000000000000111000000000000111111111111111111111
111000000000000000000000000111000000000000000001111111111111111
111000000000000000000000000111000000000000000000001111111111111
111111111111100000110000000111111111000000000000000000011111111
100000000000000000110000000111111111000000000000000000011111111
100000000000000000110000000111111111111111110000000000011111111
111100000000000000110000000000000111111111110000000000000000001
111100000001111111110000000000000111111111110000000000000000001
111100000001111111110000000000000111118888110000000000000000001
100000000000000000000000000000000111118688111111111111100000001
100000000000000000000000000000000111118888111111111111100000001
100000000000000000000000000111111111118888111000000000000000001
111111111000111000011111111111111111118811111000000000000000001
111111111000111000000000000000000000000011111000000000000000001
111111111000111000000000000000000000000011111000000000111111111
100000000000111000000000000000000000000011111000000000111111111
100000000000111000000000000000000000000011111000000000111111111
100000040000000000011111111111111111000000000000000000000000001
100000000000000000011111111111111111000000000000000000000050001
100000000000000000011111111111111111000000000000000000000000001
111111111111111111111111111111111111111111111111111111111111111
