111111111111111111111111111111111111111111111111111111111111111
100000000011000000000000000000000000000000000000000000000000001
100000000011000000000000000000000000000000000000000000000000001
100000000011000000000000000000000000000000000000000000000000001
100000000011000000000000000000000000000000000000000000000000001
100000000011000000000000000000000000000000000000004000000000001
100000000011000000000000000000000000000000000000000000000000001
100000000011000000000000000000000000000000000000000000000000001
100000000000000000000000000000000000000000000000000000000000001
100000000000000000000000000000000000000000000000000000000000001
100000000000000000000000000000000000000000000000000000000000001
100000000000000000000000000000000000000000000000000000000000001
100000000000000000000000000000000000000000000000000000000000001
100000000000000000000000000000000000000000000000000000000000001
100000000000000000000000000000000000000000000000000000000000001
100000000000000000000000000000000000000000000000000000000000001
100000000000000000000000000000000000000000000000000000000000001
100000000000000000000000000000000000000000000000000000000000001
100000000000000000000000000000000000000000000000000000000000001
100000000000000000000000000000000000000000000000000000000000001
100000000000000000000000000000000000000000000000000000000000001
100000000000000000000000000000000000000000000000000000000000001
100000000000000000000000000000000000000000000000000000000000001
100000000000000000000001111111111111111111111100000000000000001
100000000000000000000001111111111111111111111100000000000000001
100000000000000000000001110000000000000000001100000000000111111
100000000000000000000001110000000000000000001100000000000111111
100000000000000000000001110000000000000000001100000000000111111
100000000000000000000001110000000000000000001100000000000111111
100000000000000000000001110000000000000000001100000000000111111
100000000000000000000001110000001111100000001100000000000111611
100000000000000000000001110000001111100000001100000000000111111
100000000000000000000001100000000001100000000000000000000111111
100000000000000000000001100500030001100000000000000000011111111
100000000000000000000001100000000001100000000000000000011111111
111111111111111111111111111111111111111111111111111111111111111